11111111111111111
10000000000000E01
10000000000000001
100P0000000C00001
11111111111111111
