1111111111
1000000001
100E0000C1
100000C001
100P000001
1111111111
