111111111111111111111111111111111111111111111111111111111111111111111111111111111111111111111111111111111111111111111111111111
1P0000000000000000000000000000000000000000000000000000000000000000000000000000000000000000000000000000000000000000000000000011
1C0000000000000000000000000000000000000000000000000000000000000000000000000000000000000000000000000000000000000000000000000011
1C0000000000000000000000000000000000000000000000000000000000000000000000000000000000000000000000000000000000000000000000000011
1C0000000000000000000000000000000000000000000000000000000000000000000000000000000000000000000000000000000000000000000000000011
1C0000000000000000000000000000000000000000000000000000000000000000000000000000000000000000000000000000000000000000000000000011
1C0000000000000000000000000000000000000000000000000000000000000000000000000000000000000000000000000000000000000000000000000011
1C0000000000000000000000000000000000000000000000000000000000000000000000000000000000000000000000000000000000000000000000000011
1C0000000000000000000000000000000000000000000000000000000000000000000000000000000000000000000000000000000000000000000000000011
1C0000000000000000000000000000000000000000000000000000000000000000000000000000000000000000000000000000000000000000000000000011
1C0000000000000000000000000000000000000000000000000000000000000000000000000000000000000000000000000000000000000000000000000011
1C0000000000000000000000000000000000000000000000000000000000000000000000000000000000000000000000000000000000000000000000000011
1C0000000000000000000000000000000000000000000000000000000000000000000000000000000000000000000000000000000000000000000000000011
1C0000000000000000000000000000000000000000000000000000000000000000000000000000000000000000000000000000000000000000000000000011
1C0000000000000000000000000000000000000000000000000000000000000000000000000000000000000000000000000000000000000000000000000011
1C0000000000000000000000000000000000000000000000000000000000000000000000000000000000000000000000000000000000000000000000000011
1C00000000000000000000000000000000000000000000000000000000000000000000000000000000000000000000000000000000000000000000000000E1
111111111111111111111111111111111111111111111111111111111111111111111111111111111111111111111111111111111111111111111111111111