1111111111111111111111111111111111111111111111111111111111111111111111111111111111111111111111
1000000000000000000000000000000000000000000000000000000000000000000000000000000000000000000011
1P00111111111111110001000000000000010001111111111111110001111111111111000111111111111111100011
1C00100000000000000001000000000000010001000000000000010001000000000000100000000011000000000011
1C00100000000000000001000000000000010001000000000000010001000000000000100000000011000000000011
1C00100000000000000001000000000000010001000000000000010001000000000000100000000011000000000011
1C00100000000000000001111111111111110001111111111111110001000000000000100000000011000000000011
1C00100000000000000001000000000000010001000000000000010001000000000000100000000011000000000011
1C00100000000000000001000000000000010001000000000000010001000000000000100000000011000000000011
1C00100000000000000001000000000000010001000000000000010001000000000000100000000011000000000011
1C00100000000000000001000000000000010001000000000000010001000000000000100000000011000000000011
1C00111111111111110001000000000000010001000000000000010001111111111111000111111111111111110011
1C000000000000000000000000000000000000000000000000000000000000000000000000000000000000000000E1
1111111111111111111111111111111111111111111111111111111111111111111111111111111111111111111111
