11111111111111111111111111111111111111111111111111111111111111111111111111111111111111111
10000000000000000000000000000000000000000000000000000000000000000000000000000000000000011
1P001111111111111000100000000000010001111111111111100011111111111100011111111111111110011
1C001000000000000000100000000000010001000000000000100010000000000010000000001100000000011
1C001000000000000000100000000000010001000000000000100010000000000010000000001100000000011
1C001000000000000000100000000000010001000000000000100010000000000010000000001100000000011
1C001000000000000000111111111111110001111111111111100010000000000010000000001100000000011
1C001000000000000000100000000000010001000000000000100010000000000010000000001100000000011
1C001000000000000000100000000000010001000000000000100010000000000010000000001100000000011
1C001000000000000000100000000000010001000000000000100010000000000010000000001100000000011
1C001000000000000000100000000000010001000000000000100010000000000010000000001100000000011
1C001111111111111000100000000000010001000000000000100011111111111100011111111111111110011
1C0000000000000000000000000000000000000000000000000000000000000000000000000000000000000E1
11111111111111111111111111111111111111111111111111111111111111111111111111111111111111111