1111111111111111111111111111111111111111111111111111111111111111111111111111111111111
100000000000000000000000000000000000000000PE00000000000000000000000000000000000000001
1000000000000000000000000000000000000000000000000000000000000000000000000000000000001
1000000111111111111110000001111111111111000000111000000011100000011111111111110000001
1000000110000000000000000001100000000011000000110100000101100000011000000000000000001
1000000110000000000000000001100000000011000000110011111001100000011000000000000000001
1000000110000000111110000001111111111111000000110001110001100000011111111000000000001
1000000110000000111110000001100000000011000000110000000001100000011000000000000000001
1000000110000000000110000001100000000011000000110000000001100000011000000000000000001
1000000111111111111110000001100000000011000000110000000001100000011111111111110000001
1000000000000000000000000000000000000000000000000000000000000000000000000000000000001
1000000CCCCCCCCCCCCCCCCCCCCCCCCCCCCCCCCCCCCCCCCCCCCCCCCCCCCCCCCCCCCCCCCCCCCCCC0000001
1000000000000000000000000000000000000000000000000000000000000000000000000000000000001
1111111111111111111111111111111111111111111111111111111111111111111111111111111111111