1111111111111111111111111111111111111111111111111111111111111111111111111111111111111111111111111111
1111111111111111111111111111111111111111111111111111111111111111111111111111111111111111111111111111
11000P000CCCCCCCCCCCCCCCCCCCCCCCCC000000000000000000000000000000000000000000000000000000000000000011
110000000111111111111111111111111C000000000000000000000000000000000000000000000000000000000000000011
110000000000000000000000000000001C000000000000000000000000000000000000000000000000000000000000000011
110000000000000000000000000000001C000000000000000000000000000000000000000000000000000000000000000011
110000000000000000000000000000001C000000000000000000000000000000000000000000000000000000000000000011
110000000000000000000000000000001C000000000000000000000000000000000000000000000000000000000000000011
110000000000000000000000000000001C000000000000000000000000000000000000000000000000000000000000000011
110000000000000000000000000000001C000000000000000000000000000000000000000000000000000000000000000011
110000000000000000000000000000001CCCCCCCCCCCCCCCCCCCCCCCCCCC0000000000000000000000000000000000000011
11000000000000000000000000000000111111111111111111111111111C0000000000000000000000000000000000000011
11000000000000000000000000000000000000000000000000000000001C0000000000000000000000000000000000000011
11000000000000000000000000000000000000000000000000000000001C0000000000000000000000000000000000000011
11000000000000000000000000000000000000000000000000000000001C0000000000000000000000000000000000000011
11000000000000000000000000000000000000000000000000000000001C0000000000000000000000000000000000000011
11000000000000000000000000000000000000000000000000000000001C0000000000000000000000000000000000000011
11000000000000000000000000000000000000000000000000000000001C0000000000000000000000000000000000000011
11000000000000000000000000000000000000000000000000000000001C0000000000000000000000000000000000000011
11000000000000000000000000000000000000000000000000000000001CCCCCCCCCCCCCCCCCCCCCCCCCC000000000000011
110000000000000000000000000000000000000000000000000000000011111111111111111111111111C000000000000011
110000000000000000000000000000000000000000000000000000000000000000000000000000000001C000000000000011
110000000000000000000000000000000000000000000000000000000000000000000000000000000001C000000000000011
110000000000000000000000000000000000000000000000000000000000000000000000000000000001C000000000000011
110000000000000000000000000000000000000000000000000000000000000000000000000000000001C000000000000011
110000000000000000000000000000000000000000000000000000000000000000000000000000000001C000000000000011
110000000000000000000000000000000000000000000000000000000000000000000000000000000001C000000000000011
110000000000000000000000000000000000000000011111111111111111111111111111111111111111C000000000000011
11000000000000000000000000000000000000000001CCCCCCCCCCCCCCCCCCCCCCCCCCCCCCCCCCCCCCCCC000000000000011
11000000000000000000000000000000000000000001C0000000000000000000000000000000000000000000000000000011
11000000000000000000000000000000000000000001C0000000000000000000000000000000000000000000000000000011
11000000000000000000000000000000000000000001C0000000000000000000000000000000000000000000000000000011
11000000000000000000000000000000000000000001C0000000000000000000000000000000000000000000000000000011
11000000000000000000000000000000000000000001C0000000000000000000000000000000000000000000000000000011
11000000000000000000000000000000000000000001C0000000000000000000000000000000000000000000000000000011
11000000000000000000000000000000000000000001C0000000000000000000000000000000000000000000000000000011
11000000000000000000000000000000000000000001C0000000000000000000000000000000000000000000000000000011
11000000000000000000000000000000000000000001C0000000000000000000000000000000000000000000000000000011
11000000000000000000000000000000000000000001C0000000000000000000000000000000000000000000000000000011
11000000000000000000000000000000000000000001C0000000000000000000000000000000000000000000000000000011
11000000000000000000000000000000000000000001C0000000000000000000000000000000000000000000000000000011
11000000000000000000000000000000000000000001C0000000000000000000000000000000000000000000000000000011
11000000000000000000000000000000000000000001C0000000000000000000000000000000000000000000000000000011
11000000000000000000000000000000000000000001C0000000000000000000000000000000000000000000000000000011
11000000000000000000000000000000000000000001C0000000000000000000000000000000000000000000000000000011
11000000000000000000000000000000000000000001C00000000000000000000000000000000000000000000000000000E1
11000000000000000000000000000000000000000001CCCCCCCCCCCCCCCCCCCCCCCCCCCCCCCCCCCCCCCCCC00000000000011
1100000000000000000000000000000000000000000111111111111111111111111111111111111111111111111111111111
1100000000000000000000000000000000000000000000000000000000000000000000000000000000000000000000000011
1100000000000000000000000000000000000000000000000000000000000000000000000000000000000000000000000011
1111111111111111111111111111111111111111111111111111111111111111111111111111111111111111111111111111